made -> edam
malayalam -> malayalam
mam -> mam
man -> nam
mar -> ram
marc -> cram
mare -> eram
mart -> tram
mas -> sam
mat -> tam
may -> yam
me -> em
medoc -> codem
meed -> deem
meet -> teem
mem -> mem
men -> nem
mer -> rem
met -> tem
meter -> retem
mew -> wem
mho -> ohm
mi -> im
mid -> dim
milo -> olim
min -> nim
mine -> enim
mined -> denim
larum -> mural
las -> sal
laud -> dual
lb -> bl
lc -> cl
le -> el
led -> del
leda -> adel
lee -> eel
leef -> feel
leek -> keel
leer -> reel
lees -> seel
leg -> gel
leper -> repel
let -> tel
lev -> vel
level -> level
lever -> revel
lf -> fl
lg -> gl
li -> il
liar -> rail
lin -> nil
lira -> aril
live -> evil
lived -> devil
lk -> kl
ll -> ll
lll -> lll
llud -> dull
lm -> ml
ln -> nl
loop -> pool
loot -> tool
lp -> pl
m -> m
ma -> am
mab -> bam
mac -> cam
mad -> dam
madam -> madam
irenic -> cineri
is -> si
it -> ti
iv -> vi
jar -> raj
jb -> bj
je -> ej
jf -> fj
jp -> pj
kayak -> kayak
kazak -> kazak
kb -> bk
keel -> leek
keep -> peek
kf -> fk
kg -> gk
kl -> lk
knit -> tink
knob -> bonk
kook -> kook
kr -> rk
kw -> wk
l -> l
la -> al
lab -> bal
laced -> decal
lad -> dal
lag -> gal
lager -> regal
laid -> dial
lamina -> animal
lana -> anal
lap -> pal
a -> a
ab -> ba
aba -> aba
abba -> abba
abut -> tuba
ac -> ca
acrid -> dirca
acu -> uca
ad -> da
adad -> dada
adde -> edda
adel -> leda
aes -> sea
aga -> aga
agas -> saga
agir -> riga
agni -> inga
ah -> ha
aha -> aha
ajar -> raja
al -> la
ala -> ala
alla -> alla
r -> r
ra -> ar
radar -> radar
rag -> gar
rages -> segar
rail -> liar
raj -> jar
raja -> ajar
ram -> mar
rao -> oar
rap -> par
rast -> tsar
rat -> tar
rats -> star
raw -> war
rd -> dr
re -> er
rebut -> tuber
red -> der
reed -> deer
reel -> leer
refer -> refer
regal -> lager
regna -> anger
rem -> mer
remit -> timer
remus -> sumer
rep -> per
repel -> leper
res -> ser
retem -> meter
revel -> lever
reward -> drawer
rf -> fr
er -> re
era -> are
eram -> mare
erat -> tare
ere -> ere
erg -> gre
ergo -> ogre
eris -> sire
erit -> tire
eros -> sore
es -> se
esse -> esse
et -> te
eta -> ate
etna -> ante
eve -> eve
even -> neve
evil -> live
evove -> evove
ewe -> ewe
eye -> eye
fac -> caf
farad -> daraf
fb -> bf
fd -> df
feel -> leef
ff -> ff
fg -> gf
fh -> hf
fires -> serif
fj -> jf
fk -> kf
fl -> lf
fled -> delf
flog -> golf
flow -> wolf
fr -> rf
fv -> vf
g -> g
gab -> bag
gag -> gag
gal -> lag
gar -> rag
garb -> brag
gas -> sag
gat -> tag
gb -> bg
gc -> cg
gd -> dg
ge -> eg
geb -> beg
gel -> leg
td -> dt
te -> et
tebet -> tebet
teem -> meet
teg -> get
tel -> let
telum -> mulet
tem -> met
ten -> net
tenet -> tenet
terret -> terret
tet -> tet
ti -> it
tic -> cit
tide -> edit
time -> emit
timer -> remit
tin -> nit
tink -> knit
tip -> pit
tips -> spit
tire -> erit
tis -> sit
tit -> tit
tnt -> tnt
to -> ot
tod -> dot
tom -> mot
tomtom -> motmot
ton -> not
tons -> snot
tool -> loot
toot -> toot
top -> pot
tops -> spot
tor -> rot
tort -> trot
tot -> tot
tow -> wot
trad -> dart
tram -> mart
trap -> part
trapa -> apart
pin -> nip
pins -> snip
pip -> pip
pis -> sip
pit -> tip
pj -> jp
pl -> lp
plug -> gulp
pm -> mp
pooh -> hoop
pool -> loop
poop -> poop
pop -> pop
port -> trop
pot -> top
pow -> wop
prod -> dorp
pu -> up
pup -> pup
puris -> sirup
pus -> sup
put -> tup
q -> q
cen -> nec
cg -> gc
ch -> hc
cic -> cic
cineri -> irenic
cit -> tic
cito -> otic
civic -> civic
cl -> lc
cn -> nc
codem -> medoc
bud -> dub
bun -> nub
bur -> rub
burg -> grub
bus -> sub
but -> tub
c -> c
ca -> ac
caf -> fac
cam -> mac
cares -> serac
cb -> bc
cc -> cc
cor -> roc
cos -> soc
cr -> rc
cram -> marc
cran -> narc
cv -> vc
d -> d
da -> ad
dab -> bad
dad -> dad
dada -> adad
dal -> lad
dam -> mad
damon -> nomad
dap -> pad
daraf -> farad
dart -> trad
das -> sad
dat -> tad
daws -> swad
db -> bd
dd -> dd
de -> ed
debut -> tubed
decal -> laced
ded -> ded
deed -> deed
deem -> meed
deer -> reed
del -> led
delf -> fled
denim -> mined
sm -> ms
smug -> gums
smut -> tums
snip -> pins
snot -> tons
snug -> guns
so -> os
sob -> bos
soc -> cos
sod -> dos
son -> nos
sore -> eros
sos -> sos
sous -> suos
spat -> taps
spit -> tips
spot -> tops
star -> rats
alula -> alula
am -> ma
ama -> ama
amor -> roma
an -> na
ana -> ana
anal -> lana
anas -> sana
anasa -> asana
anger -> regna
animal -> lamina
anna -> anna
anon -> nona
ante -> etna
anu -> una
apart -> trapa
ar -> ra
ara -> ara
arab -> bara
aras -> sara
are -> era
ares -> sera
aril -> lira
artamus -> sumatra
as -> sa
asana -> anasa
at -> ta
ate -> eta
aut -> tua
avid -> diva
avis -> siva
ayr -> rya
ba -> ab
bad -> dab
bag -> gab
bal -> lab
bam -> mab
ban -> nab
bara -> arab
bard -> drab
bat -> tab
bb -> bb
bc -> cb
bd -> db
be -> eb
trig -> girt
trop -> port
trot -> tort
trow -> wort
tsar -> rast
tu -> ut
tua -> aut
tub -> but
tuba -> abut
tubed -> debut
tuber -> rebut
tug -> gut
tums -> smut
tun -> nut
tup -> put
tut -> tut
u -> u
uca -> acu
un -> nu
una -> anu
strap -> parts
stun -> nuts
su -> us
sub -> bus
succor -> roccus
sum -> mus
sumatra -> artamus
sumer -> remus
suos -> sous
sup -> pus
sur -> rus
sus -> sus
swad -> daws
sway -> yaws
ta -> at
tab -> bat
tad -> dat
tag -> gat
tam -> mat
tang -> gnat
tao -> oat
tap -> pat
taps -> spat
tar -> rat
tare -> erat
tat -> tat
taw -> wat
get -> teg
gf -> fg
gg -> gg
gib -> big
gig -> gig
girt -> trig
gk -> kg
gl -> lg
gnat -> tang
gob -> bog
god -> dog
gog -> gog
golf -> flog
gr -> rg
gre -> erg
grub -> burg
gulp -> plug
gum -> mug
gums -> smug
guns -> snug
gur -> rug
gut -> tug
ha -> ah
hap -> pah
hay -> yah
hb -> bh
hc -> ch
heh -> heh
hey -> yeh
hf -> fh
ho -> oh
hoop -> pooh
huh -> huh
i -> i
ibi -> ibi
ibis -> sibi
neve -> even
new -> wen
ni -> in
nib -> bin
nil -> lin
nim -> min
nip -> pin
nis -> sin
nit -> tin
nl -> ln
no -> on
nob -> bon
nod -> don
nom -> mon
nomad -> damon
non -> non
nona -> anon
noon -> noon
nor -> ron
nos -> son
not -> ton
now -> won
nu -> un
nub -> bun
nun -> nun
nut -> tun
nuts -> stun
o -> o
oar -> rao
oat -> tao
ob -> bo
od -> do
odi -> ido
ofo -> ofo
ogre -> ergo
oh -> ho
ohm -> mho
olim -> milo
om -> mo
omen -> nemo
on -> no
or -> ro
oro -> oro
id -> di
ido -> odi
igigi -> igigi
ii -> ii
iii -> iii
il -> li
im -> mi
in -> ni
inani -> inani
inga -> agni
beg -> geb
ben -> neb
bf -> fb
bg -> gb
bh -> hb
bib -> bib
bid -> dib
big -> gib
bin -> nib
bis -> sib
bj -> jb
bk -> kb
bl -> lb
bo -> ob
bob -> bob
bog -> gob
bon -> nob
bonk -> knob
boob -> boob
bos -> sob
bp -> pb
brag -> garb
dr -> rd
drab -> bard
draw -> ward
drawer -> reward
dray -> yard
drow -> word
dt -> td
dual -> laud
dub -> bud
dud -> dud
dull -> llud
dum -> mud
e -> e
eb -> be
ecce -> ecce
ed -> de
edam -> made
edda -> adde
edit -> tide
eel -> lee
eg -> ge
ej -> je
eke -> eke
el -> le
em -> me
emir -> rime
emit -> time
en -> ne
ene -> ene
enim -> mine
der -> red
des -> sed
devil -> lived
dew -> wed
df -> fd
dg -> gd
di -> id
dial -> laid
dib -> bid
did -> did
dim -> mid
dirca -> acrid
diva -> avid
do -> od
dog -> god
don -> nod
doom -> mood
door -> rood
dor -> rod
dorp -> prod
dos -> sod
dot -> tod
up -> pu
us -> su
ut -> tu
utu -> utu
v -> v
vc -> cv
vel -> lev
vf -> fv
vi -> iv
os -> so
ot -> to
otic -> cito
oto -> oto
otto -> otto
ovo -> ovo
p -> p
pad -> dap
pah -> hap
pal -> lap
pan -> nap
pap -> pap
par -> rap
part -> trap
parts -> strap
pas -> sap
pat -> tap
pay -> yap
pb -> bp
peek -> keep
peep -> peep
pep -> pep
per -> rep
vr -> rv
war -> raw
ward -> draw
was -> saw
wat -> taw
waw -> waw
way -> yaw
wed -> dew
wem -> mew
wen -> new
wk -> kw
wolf -> flow
won -> now
wop -> pow
word -> drow
wort -> trow
wot -> tow
wow -> wow
x -> x
y -> y
yah -> hay
yam -> may
yap -> pay
yard -> dray
yaw -> way
yaws -> sway
yay -> yay
yeh -> hey
z -> z
riga -> agir
rim -> mir
rime -> emir
rk -> kr
ro -> or
roc -> cor
roccus -> succor
rod -> dor
roma -> amor
ron -> nor
rood -> door
room -> moor
rot -> tor
rotor -> rotor
rub -> bur
rug -> gur
rus -> sur
rv -> vr
rya -> ayr
s -> s
sa -> as
sad -> das
sag -> gas
saga -> agas
sal -> las
sam -> mas
sana -> anas
sap -> pas
sara -> aras
saw -> was
se -> es
sea -> aes
sed -> des
seel -> lees
segar -> rages
senes -> senes
ser -> res
sera -> ares
serac -> cares
serif -> fires
ses -> ses
si -> is
sib -> bis
sibi -> ibis
sin -> nis
sip -> pis
sire -> eris
siris -> siris
sirup -> puris
sit -> tis
siva -> avis
minim -> minim
mir -> rim
ml -> lm
mo -> om
mom -> mom
mon -> nom
mood -> doom
moor -> room
mot -> tom
motmot -> tomtom
mp -> pm
ms -> sm
mud -> dum
mug -> gum
mulet -> telum
mum -> mum
mural -> larum
mus -> sum
mutum -> mutum
n -> n
na -> an
nab -> ban
nam -> man
nap -> pan
narc -> cran
nauruan -> nauruan
nc -> cn
ne -> en
neb -> ben
nec -> cen
nem -> men
nemo -> omen
net -> ten
